0,55,2,2,2,4,1,2,1,3
13,30,30,30,30,30,30,30,30,16
13,18,30,30,30,30,28,30,30,29
13,30,30,28,30,30,30,30,30,16
13,65,65,65,14,14,14,14,14,29
13,30,30,27,20,20,20,20,20,29
26,30,30,27,27,27,28,30,30,29
13,30,30,28,27,27,30,30,30,48
13,30,30,30,18,27,30,30,30,29
39,41,41,40,34,54,21,40,41,42
